<?php

$npc=array(

'char'=>'coêoë|8|8|1|1||||2||||',

'war'=>'90|0|4|3|||15||||||êëşâoì|2||',

'osvej'=>'i.h.p.perya:12',

);