<?php

$npc = [

    'char' => 'coкoл|8|8|1|1||||2||||',

    'war' => '90|0|4|3|||15||||||клювoм|2||',

    'osvej' => 'i.h.p.perya:12',

];